OOOOOOOOOO
OOO###OOOO
OO##X#OOOO
OO# C####O
O##b  CE#O
O#X CCX##O
O#### ##OO
OOOO#X#OOO
OOOO###OOO
OOOOOOOOOO