OOOOOOOOOO
O########O
O#  #   #O
O# CXXC #O
O#ECXZ ##O
O# CXXC #O
O#  #   #O
O########O
OOOOOOOOOO
OOOOOOOOOO