OOOOOOOOOO
OOO#####OO
O###b E#OO
O#  CX ##O
O#  XCX #O
O### ZC #O
OOO#   ##O
OOO#####OO
OOOOOOOOOO
OOOOOOOOOO