#####OOOOO
# E #OOOOO
# CC#O###O
# C #O#X#O
### ###X#O
O##    X#O
O#b  #  #O
O#   ####O
O#####OOOO
OOOOOOOOOO
                   


