OOOOOOOOOO
OOO####OOO
OO##  #OOO                   
OO#bEC#OOO
OO##C ##OO
OO## C #OO
OO#XC  #OO
OO#XXZX#OO
OO######OO
OOOOOOOOOO